"a" = (/turf/space,/area/space)
"b" = (/obj/effect/landmark/map_data{height = 2},/turf/space,/area/space)
"c" = (/turf/simulated/wall)
"d" = (/obj/effect/floor_decal/corner/blue/diagonal,/turf/simulated/floor/tiled)
"e" = (/obj/machinery/light{dir = 1},/obj/effect/floor_decal/corner/blue/diagonal,/turf/simulated/floor/tiled)
"f" = (/obj/structure/lattice,/turf/simulated/open)
"g" = (/turf/simulated/open)
"h" = (/obj/machinery/light_switch{pixel_x = 25},/obj/effect/floor_decal/corner/blue/diagonal,/turf/simulated/floor/tiled)
"j" = (/obj/machinery/light{icon_state = "tube1"; dir = 8},/obj/effect/floor_decal/corner/blue/diagonal,/turf/simulated/floor/tiled)
"k" = (/obj/effect/floor_decal/corner/blue/diagonal,/obj/structure/ladder,/turf/simulated/floor/tiled)
"l" = (/turf/simulated/floor)
"m" = (/obj/machinery/embedded_controller/radio/simple_docking_controller{id_tag = "upper_level_dock"; pixel_x = 8; pixel_y = -25},/turf/simulated/floor)
"n" = (/obj/machinery/door/airlock/external/bolted{frequency = 1379},/turf/simulated/floor)
"o" = (/obj/machinery/atmospherics/unary/vent_pump/on,/obj/effect/floor_decal/corner/blue/diagonal,/turf/simulated/floor/tiled)
"p" = (/obj/effect/floor_decal/corner/blue/diagonal,/obj/machinery/light{icon_state = "tube1"; dir = 4},/turf/simulated/floor/tiled)
"q" = (/obj/machinery/atmospherics/pipe/simple/visible{icon_state = "intact"; dir = 5},/obj/effect/floor_decal/corner/blue/diagonal,/turf/simulated/floor/tiled)
"r" = (/obj/machinery/atmospherics/pipe/simple/visible{icon_state = "intact"; dir = 4},/obj/effect/floor_decal/corner/blue/diagonal,/turf/simulated/floor/tiled)
"s" = (/obj/machinery/atmospherics/portables_connector{icon_state = "map_connector"; dir = 8},/obj/machinery/portable_atmospherics/canister/air,/obj/effect/floor_decal/corner/blue/diagonal,/turf/simulated/floor/tiled)
"t" = (/obj/machinery/atmospherics/pipe/simple/visible{icon_state = "intact"; dir = 6},/obj/effect/floor_decal/corner/blue/diagonal,/turf/simulated/floor/tiled)
"u" = (/obj/machinery/atmospherics/portables_connector{icon_state = "map_connector"; dir = 8},/obj/machinery/portable_atmospherics/canister/empty,/obj/effect/floor_decal/corner/blue/diagonal,/turf/simulated/floor/tiled)
"v" = (/obj/machinery/light_switch{pixel_x = -25},/obj/effect/floor_decal/corner/blue/diagonal,/turf/simulated/floor/tiled)
"w" = (/obj/machinery/atmospherics/unary/vent_scrubber/on{icon_state = "map_scrubber_on"; dir = 1},/obj/effect/floor_decal/corner/blue/diagonal,/turf/simulated/floor/tiled)
"x" = (/obj/machinery/light{icon_state = "tube1"; dir = 4},/obj/effect/floor_decal/corner/blue/diagonal,/turf/simulated/floor/tiled)
"y" = (/obj/structure/cable{d2 = 2; icon_state = "0-2"; pixel_y = 0},/obj/machinery/power/apc{dir = 8; name = "west bump"; pixel_x = -24},/obj/effect/floor_decal/corner/blue/diagonal,/turf/simulated/floor/tiled)
"z" = (/obj/structure/cable{d1 = 1; d2 = 2; icon_state = "1-2"; pixel_y = 0},/obj/effect/floor_decal/corner/blue/diagonal,/turf/simulated/floor/tiled)
"A" = (/obj/structure/cable,/obj/machinery/power/debug_items/infinite_generator,/obj/effect/floor_decal/corner/blue/diagonal,/turf/simulated/floor/tiled)
"B" = (/obj/machinery/light,/obj/effect/floor_decal/corner/blue/diagonal,/turf/simulated/floor/tiled)

(1,1,1) = {"
aaaaaaaaaaaaaaaaaaaaaaaaaaaaaaaaaaaaaaaaaaaaaaaa
aaaaaaaaaaaaaaaaaaaaaaaaaaaaaaaaaaaaaaaaaaaaaaaa
aaaaaaaaaaaaaaaaaaaaaaaaaaaaaaaaaaaaaaaaaaaaaaaa
aaaaaaaaaaaaaaaaaaaaaaaaaaaaaaaaaaaaaaaaaaaaaaaa
aaaaaaaaaaaaaaaaaaaaaaaaaaaaaaaaaaaaaaaaaaaaaaaa
aaaaaaaaaaaaaaaaaaaaaaaaaaaaaaaaaaaaaaaaaaaaaaaa
aaaaaaaaaaaaaaaaaaaaaaaaaaaaaaaaaaaaaaaaaaaaaaaa
aaaaaaaaaaaaaaaaaaaaaaaaaaaaaaaaaaaaaaaaaaaaaaaa
aaaaaaaaaaaaaaaaaaaaaaaaaaaaaaaaaaaaaaaaaaaaaaaa
aaaaaaaaaaaaabaaacccccccccccccccaaaaaaaaaaaaaaaa
aaaaaaaaaaaaaaaaacdddeddfddedddcaaaaaaaaaaaaaaaa
aaaaaaaaaaaaaaaaacdddddfffdddddcaaaaaaaaaaaaaaaa
aaaaaaaaaaaaaaaaacdddddgggddddhccccaaaaaaaaaaaaa
aaaaaaaaaaaaaaaaacjdddkgggdddddllmnaaaaaaaaaaaaa
aaaaaaaaaaaaaaaaacddddddddddodpccccaaaaaaaaaaaaa
aaaaaaaaaaaaaaaaacddddddddddqrscaaaaaaaaaaaaaaaa
aaaaaaaaaaaaaaaaacdddddddddddddcaaaaaaaaaaaaaaaa
aaaaaaaaaaaaaaaaacddddddddddtrucaaaaaaaaaaaaaaaa
aaaaaaaaaaaaaaaaacvdddddddddwddcaaaaaaaaaaaaaaaa
aaaaaaaaaaaaaaaaacjdddddddddddxcaaaaaaaaaaaaaaaa
aaaaaaaaaaaaaaaaacyddddddddddddcaaaaaaaaaaaaaaaa
aaaaaaaaaaaaaaaaaczddddddddddddcaaaaaaaaaaaaaaaa
aaaaaaaaaaaaaaaaacAddBdddddBdddcaaaaaaaaaaaaaaaa
aaaaaaaaaaaaaaaaacccccccccccccccaaaaaaaaaaaaaaaa
aaaaaaaaaaaaaaaaaaaaaaaaaaaaaaaaaaaaaaaaaaaaaaaa
aaaaaaaaaaaaaaaaaaaaaaaaaaaaaaaaaaaaaaaaaaaaaaaa
aaaaaaaaaaaaaaaaaaaaaaaaaaaaaaaaaaaaaaaaaaaaaaaa
aaaaaaaaaaaaaaaaaaaaaaaaaaaaaaaaaaaaaaaaaaaaaaaa
aaaaaaaaaaaaaaaaaaaaaaaaaaaaaaaaaaaaaaaaaaaaaaaa
aaaaaaaaaaaaaaaaaaaaaaaaaaaaaaaaaaaaaaaaaaaaaaaa
aaaaaaaaaaaaaaaaaaaaaaaaaaaaaaaaaaaaaaaaaaaaaaaa
aaaaaaaaaaaaaaaaaaaaaaaaaaaaaaaaaaaaaaaaaaaaaaaa
"}
